HHHHHHHHHHHHHHHHHHHHHHHHHHHHHHHHHHHHHHHHHHHHHHHHHHHHHHHHHHHHHHHHHHHHHHHHHHHHHHHH
H@::::::::::::::::::::::::::H::::HHHHHHHHHHHHHHHHHHHHHHHHHHHHHHHHHHHHHHHHHHH:::H
HH::::::::::::::::::::::::::S::::HHHHHHHHHHHHHHHHHHHHHHHHHHHHHHHHHHHHHHHHHHH:::H
HH::::::::::::::::::::::::::HHHHHHHHHHHHHHHHHHHHHHHHHHHHHHHHHHHHHHHHHHHHHHHHHHHH
HHHHHHHHHHHH::HHHHHHHHHH:::::::::::::::::::::::::HHHHHHHHHHHHHHHHHHHHHHHHHHHHHHH
HHHHHHHHHHHH::HHHHHHHHHH::::HHHHHHHHHHHHHHHHHHH::HHHHHHHHHHHHHHHHHHHHHHHHHHHHHHH
HH:::::::::H::::::::::::::::H::::::::::::HHHHHH::HHHHHHHHHHHHHHHHHHHHHHHHHHHHHHH
HH::$:::::::::HHHHHHHHHHHHHHH::::::::::::HHHHHH::HHHHHHHHHHHHHHHHHHHHHHHHHHHHHHH
HH:::::::::H::H:::::::::::::H::::::::::::HHHHHH::HHHHHHHHHHHHHHHHHHHHHHHHHHHHHHH
HHHHHHHHHHHH::H::::::::::::::$:::::::::::HHHHHH::HHHHHHHHHHHHHHHHHHHHHHHHHHHHHHH
HHHHHHHHHHHH::HHHHHHHHHHHH:HHHHHHHHHHHHHHHHHHHH::HHHHHHHHHHHHHHHHHHHHHHHHHHHHHHH
HHHHHHHHHHHH:::::::::::::::::::::::::::::::::::::HHHHHHHHHHHHHHHHHHHHHHHHHHHHHHH
HHHHHHHHHHHH:::::::::::::::::::::::::::::::::::::HHHHHHHHHHHHHHHHHHHHHHHHHHHHHHH
HHHHHHHHHHHHHHHHHHHHHHHHHHHHHHHHHHHHHHHHHHHHHHHHHHHHHHHHHHHHHHHHHHHHHHHHHHHHHHHH
HHHHHHHHHHHHHHHHHHHHHHHHHHHHHHHHHHHHHHHHHHHHHHHHHHHHHHHHHHHHHHHHHHHHHHHHHHHHHHHH
HHHHHHHHHHHHHHHHHHHHHHHHHHHHHHHHHHHHHHHHHHHHHHHHHHHHHHHHHHHHHHHHHHHHHHHHHHHHHHHH
HHHHHHHHHHHHHHHHHHHHHHHHHHHHHHHHHHHHHHHHHHHHHHHHHHHHHHHHHHHHHHHHHHHHHHHHHHHHHHHH
HHHHHHHHHHHHHHHHHHHHHHHHHHHHHHHHHHHHHHHHHHHHHHHHHHHHHHHHHHHHHHHHHHHHHHHHHHHHHHHH
HHHHHHHHHHHHHHHHHHHHHHHHHHHHHHHHHHHHHHHHHHHHHHHHHHHHHHHHHHHHHHHHHHHHHHHHHHHHHHHH
HHHHHHHHHHHHHHHHHHHHHHHHHHHHHHHHHHHHHHHHHHHHHHHHHHHHHHHHHHHHHHHHHHHHHHHHHHHHHHHH
HHHHHHHHHHHHHHHHHHHHHHHHHHHHHHHHHHHHHHHHHHHHHHHHHHHHHHHHHHHHHHHHHHHHHHHHHHHHHHHH
HHHHHHHHHHHHHHHHHHHHHHHHHHHHHHHHHHHHHHHHHHHHHHHHHHHHHHHHHHHHHHHHHHHHHHHHHHHHHHHH
HHHHHHHHHHHHHHHHHHHHHHHHHHHHHHHHHHHHHHHHHHHHHHHHHHHHHHHHHHHHHHHHHHHHHHHHHHHHHHHH
HHHHHHHHHHHHHHHHHHHHHHHHHHHHHHHHHHHHHHHHHHHHHHHHHHHHHHHHHHHHHHHHHHHHHHHHHHHHHHEH
HHHHHHHHHHHHHHHHHHHHHHHHHHHHHHHHHHHHHHHHHHHHHHHHHHHHHHHHHHHHHHHHHHHHHHHHHHHHHHHH

